{
  "MapName": "test 1",
  "Width": 10,
  "Height": 10,
  "TileSize": 10,
  "Start": {
    "X": 100,
    "Y": 100
  },
  "End": {
    "X": 1000,
    "Y": 1000
  },
  "PathWayPoints": [
    {
      "X": 100,
      "Y": 100
    }
  ],
  "TileSetIDs": [
    1, 1, 1, 1, 1, 1, 1, 1, 1, 1,
    1, 1, 1, 1, 1, 1, 1, 1, 1, 1,
    1, 1, 1, 1, 1, 1, 3, 1, 1, 1,
    1, 1, 2, 1, 1, 1, 1, 1, 1, 1,
    1, 1, 1, 1, 1, 1, 1, 1, 1, 1,
    1, 1, 1, 2, 1, 1, 3, 1, 1, 1,
    1, 1, 1, 1, 1, 1, 1, 1, 1, 1,
    1, 1, 1, 1, 1, 1, 1, 1, 1, 1,
    1, 1, 1, 1, 1, 1, 1, 1, 1, 1,
    1, 1, 1, 1, 1, 1, 1, 1, 1, 1
  ]
}